10 11
G . X . A . X . A .
X . X . X . X C X .
X R X Z X . X . X .
X . X . X . X . X R
X . X . X R X Z X .
X . X . X . X . X .
A . X R X . X . X .
H . X . X . X . X Z
X C X . X C X R X .
X . X . X . X . X .
X . A . X . T . X P 