10 10
P X . T . . . Z . .
. X . X R . . H . .
. X . X . . X X . Z
. X . X . . X X . .
. . H X . A X X . .
. X X X . . X X C .
Z X . . . Z X X . .
. X . R . A . . . .
. X X X X X . . X .
H . . . Z . . . X G



